0w00w0000ww0www
000www0w0w000w0
d0w0ww0w000w000
00000w000w000w0
0w0w000w000w0w0
000ww0w0ww00000
0w0000000ww0ww0
000ww0ww0ww0000
ww00www000w0w0f
www00w00w000w0w
wwww00w000w0000
wwwww000w000ww0
wwwwww0ww0wwwww
wwwww00000wwwww
wwwwwwwwwwwwwww
