0000000000000w0
0w0ww0ww0w0w000
00000000000w0w0
0w0w0w0w0w00000
0000000ww00w0w0
0w0w0w0000w000f
000000w0w0www0w
d0w0w0000000000
www0w0w0w0ww0w0
w000w0w000000w0
00w00000ww0w000
w0w0ww0w00000w0
w0000000w0ww000
www0w0w000wwww0
www00000wwwwww0
